







11111000000000000000000000000000000000000011100000000000000000000000000000000000000000000000000000000000000000000000000000000000000000000000011111
11111000000000000000000000000000000000000001100011000000000000000000000000000000000000111000000000000000000000000000000000000000000000000000011111
11111000000000000000000000000000000000000001100000000000000000000000000000000000000000000000000000000000000000000000000000000000000000000000011111
11111000000000000000000000000000000000010001100000001100000000000000000000000000111000000000111000000000000000000000000000000000000000000000011111
11111000000000000000000000000000000000000001100000000000000000000000000000000000000000000000000000000000000000000000001111110000000000000000011111
11111000000000000000000000000000000000000001100000000000110000000000000000111000000000000000000000111000000000000000000000000001100000000000011111
11111000000000000000010001000000000000000011100000000000000000000000000000000000000000000000000000000000000000000000000000000000000000000000011111
11111000000000000000000000000000000000000001100000000000000011111111111000000000000000000000000000000000111111111111111110000000000110000000011111
11111111111111111100000000001111111111111111100000000000000000000000000000000000000000000000000000000000000000000000000000000000000000001111111111
11111111111111111100000000001111111111111111100000000000000000000000000000000000000000000000000000000000000000000000000000000000000000001111111111
11111111111111111100000000001111111111111111100000000000000000000000000000000000000000000000000000000000000000000000000000000000000000001111111111
11111111111111111100000000001111111111111111100000000000000000000000000000000000000000000000000000000000000000000000000000000000000000001111111111
11111111111111111100000000001111111111111111100000000000000000000000000000000000000000000000000000000000000000000000000000000000000000001111111111